{
  "name": "Level 1",
  "width": 28,
  "height": 23,
  "legend": {
    " ": "empty",
    "#": "wall",
    "-": "platform",
    "F": "fire_pool",
    "W": "water_pool",
    "A": "acid",
    "E": "fire_door",
    "Q": "water_door",
    "R": "gem_fire",
    "B": "gem_water",
    "T": "button",
    "1": "spawn_fire",
    "2": "spawn_water"
  },
  "grid": [
    "############################",
    "#                          #",
    "#                          #",
    "#                          #",
    "#        R       B     E Q #",
    "#       -------------------#",
    "# B     #####              #",
    "#----                      #",
    "#####           -----      #",
    "#####-----------#####-     #",
    "#                       -  #",
    "#      R           B       #",
    "#     ---------------------#",
    "#  -                  ######",
    "#                          #",
    "#------------              #",
    "#            ---AA----     #",
    "# 2             ##    -    #",
    "#-------                   #",
    "#                        --#",
    "# 1        R       B    -###",
    "#---------FFF-----WW----####",
    "############################"
  ]
}
