{
  "name": "Level 2 \u2014 The Tower",
  "width": 22,
  "height": 30,
  "legend": {
    " ": "empty",
    "#": "wall",
    "-": "platform",
    "F": "fire_pool",
    "W": "water_pool",
    "A": "acid",
    "E": "fire_door",
    "Q": "water_door",
    "R": "gem_fire",
    "B": "gem_water",
    "T": "button",
    "1": "spawn_fire",
    "2": "spawn_water"
  },
  "grid": [
    "######################",
    "#       E    Q       #",
    "#     ----------     #",
    "#     R              #",
    "#  -------           #",
    "#              B     #",
    "#           -------  #",
    "#     R              #",
    "#  -------           #",
    "#              B     #",
    "#           -------  #",
    "#                    #",
    "#         WW         #",
    "#     ---FFFF---     #",
    "#                    #",
    "#    R               #",
    "#  ------            #",
    "#              B     #",
    "#            ------  #",
    "#                    #",
    "#                    #",
    "#    ------------    #",
    "#                    #",
    "#                    #",
    "#                    #",
    "#                    #",
    "#      AAAAAAAA      #",
    "#  1              2  #",
    "##-----########-----##",
    "######################"
  ]
}
